..#.#...#.#...#.##.#.......#.....##.......##..........#..###.#...#..#.#.#..#...##......###.#....
.........#....#...#.....................##..#.##..#.........##.##.#........#.##...........###...
.#......#..........##.....#....#...##..#.....#.....#.......###.#.......#......#..............#.#
.....##..........#....#.#..###...#.......#....#.....#.#.#..#....###......#..#......#..#..#.#....
.##.#..#..........#.#..#..#.......#.........#....##.........##...#..#.#.#.#..#.#..#..#.##.#.....
..#...#...#...##..##...#........#..#.....#.##..#.###....##.##..#.#...#..#####.........#.....##..
.....#...##.#.#..##...###...#.#..#.#.#.#.##...##....#.....#..#...###.##.....##..#.....#.....#.#.
#...........#..#.##.......##.##.#..#..###...##.....##....#....#.#.........#..##.#....#......##..
#.....#..#....#...##....#....###...#.#.......#.....#.....#.###...#..##.#..#.#...#...........##..
#....#....#.....##....#..###...#..#..#.#.....##.....#...#..#...##.#.###..##....#...#.#....##....
#....#........#.#...#..####.##.....##.#....#.............#..#......##...#.....##..#.#.#.#.##.#.#
#......#.#.#......###......##.....#..#.....#..#####......#..#####....#...#...#......##....#.##..
.....#..#.#..#....#.#.##..##.........#.......###....#....#..#..#...#.........#..#........#..#..#
.#..###.##..#.#...#..#..#.#.#.#.##.#..#......#.###.#....###..#....#..........##...#.#..#.#.##.#.
...#...#.#..#.....####.#.#....##.##...#.#....####..#....#...##...#.#.#....##..#.##......#....##.
.#..#.##..#...#####.......#......#..#......#.##...#.#...#........#..#####....#..........#.##....
.#.........#.....#.#....#......#..#...#...#..#...#...#..###..#..#.#.#..#..##..#........#.##.#...
#.###.#.....#.....##...#..#....#.#...#..#..#.##..#.#.#...#.....##.#.##.....#.##.#.#..#...###.#..
.....#.#..#.#.##..###..#.#.#.#.##.#..##..#....#.#...##.###...................#..##...#......#...
#####..#.#....#####.##..##.##...#....##......#....##.....#..#.#.##...#...#....#..##..#.....##.#.
..#...#..#.....##.#...#.####....##..#....#..###.#.##.##.#..#.#......####...#.#...#.#...#....#..#
#....#.#..#......#....#...#.###.#..........#.#.##..#....#...#....##.##.#...##....#..#......#....
....#.#....#.#...#.....####.#.......#.#..#.##....#.......#.........##.........##.#....#........#
....###.#.#.......#....#...###...#...#..##......###.......##.#.######........#..#.#####.........
.#.#.##...#........#...##..##...##..##....#.#..#......##..###...#.#.#....#..##..#.#.......#.....
#.#.....##....#.##.....##.#.#...#....#.##.......#.#.....##..#.#.##.#....#.#..#....#.....##..#...
#.......##.....#.#...#....#..#.###.......#..#.#...#.##.##.#..#..#....#...#..###....#...#...#..#.
#....#...##..............##..##....#....#....#.##....#.###...#...#...##................#.###....
#...#..#.#...##...#....##.#.#..##.#........#...###...#.###................##.....#...#..#..#....
#..##......#......#....##..#.#...##....###...#.#...##........##.......#....#...#..##............
..##.#...........#...###.###....#.##.#..###.#..........#...##......#..#.#.....#...#...#...#.....
.#......##....##...###.##..##..##........#...#..#...#..#....###.....##..#...##..#.#.....#.#.....
#........#.#.##.##.#............#.........##...#.....##...#..##...#..#..#.#.#.....####.#.#...#..
.#.###....#..##.#...#.###.#............#...#.#.#....##.#........#...#.#...........#....#........
.#.##..#...#...##...........#.....#....####..#..#...#.......#......#..#....####.........#.......
.#.##.....#..........#.....#..#.#........####.#...#..#.#...###..##....###...#.....##........#...
....#.....#....#..#.......##...##.....###..#...#...#####..#.#.......#.#...#...#.#.#.#..#..#....#
...#.#..###.....#......#.#.#.#...##.###...##....##.##.....###.#.#....#...#..#.#.###.....##......
.....##..#.....#...#.#....#......##..#...#.#..##...###.#....#....#.#.#..##..##.#..##.#.#..#...##
......#.#.##....#......#..#..#..........#.#..#.#............#.........#......##......#.#.#...#..
....#.........#...##..........#.......#..###....###...##....#.#.......#......##..#....#.#..##...
##.#.#........#......#...#.....#.#.#.#.#..###...#....#..#...#......##..#......##.#.#...#..#...#.
.#........#..#.##.....#....#....##..#.....#.##..#.###..........##.....###....##....#.#.#.#.....#
#.#..#...##...##.#...#.#....#..#.#..#...##....#.###.#####.##....#.##.##..#...#.......#..##....#.
##...######..#.#.#.#..#..##.#.##..##.#.....##..#..#.###.....##......###..#...#.#......##.#.#....
..#.#.#...#.#...#.......#..##...#.#.......###.##.#...###.##.#.#......#.#..#...#.#.#..######.#..#
....#....##.#.#...#.#...#....#.#....#.....#.####...........##..#..#..#...........#.....##.##....
..#..#....####.#.#.....####.......#..###..##.#..#....#.#......#...#..#..#..#...#......#.#.##....
....#.....#.###.#..###..##.#...#..#.#.........#...#.##....#..##...##....#.....##.........##..#..
.##..#.#.##...##.#..#..#..#....#....#........#...#.###.#..#....#.#..#....#...#....#..#.#....#...
.....##.##..#..#.....#.#.##..#...##.##...#.#...#...##..#....#.#.........#....###..#....##.......
....#..#.##..#..#...#.#.#..##.....##......#.##.....####...#...#...#.#..#.#..#.#.##.#.#.###......
....#........#...#.##.#.##..#......#..#..##..#...#...#...#....##...##...###..#...##.....#.#.....
.....#......#...#.#..#...#....#....#.#....##.....##.#..#....#.###..#..#.#####...#....#..........
##.###...#.##.#.#..##......##.###.#.#.......#.##....#...#...#...##.#..#.#..##.#.#.......#..#....
.....#..#...#..##.#.#..#..#......####.....##..##..#.#####.#....#..###....##..#.#....#..#.##.....
.#...#..#..#..###.#..#....##........#.#.#..#........#.###...#.#..#.##.....####.....##.#........#
.##.#..##...#..#.....#.##..#.#....#..........##..#..#.#...#...#..#...........#.#......#..##....#
...##.......#........#......#.#........#.#....##...#....#.#.#.##...##....#.###....###.#..####...
.#.###...#.#..#.....##....#...#..#....#..............#..#.........##..###............##.#.#.....
.#.#.#.#..###....##.#....########.#.....#..............#...#.#.....##.#.###..#..#..#....#..#..#.
..##............##..#..####..#.#.....#.#.##..##....##..#.......#..#.#.#..#..#..#.........###...#
#.#..........#.#...###...##.#.....#..#.#..##...#.#.#..#.#..#.##..##..#.#.#....#.....##........#.
...##.......#..#......#...#....#....#.##.#.#.##.#..#.#......###......##...#.#.........#.#.##....
...........#...#......#.....#.....##..#..##....#.#..#...###.#.##.#.####..#.....#..###..###....#.
...........#...#.#...#.......#.#.#.##.#.#......#....#..##..#....#####...###.#.#.........##......
#..##.#.#...#...##.##......####.#..##.#....#..#.#.#.#..##.........##...##...#..#........#..#....
..#..#.....#......####.#####......#..#..#.....##.#.###.#.##...#.#.##....#....#..#.......##..#.#.
#.#....##...#...##.##.#...##.....#...##...##...#..#..##.#.......#............#.#.##....#.#....##
...#....#.#.#..#.#..#..#....#...##...####.#.#..#...##..#...#...#...###........#....#.....#.....#
....#..#.#.#............#.....##.....#.........####...#......#.......##.###........#.#..##..#...
..#...#....#...#......#..##....##.....#.#..#...##.....#.#.#..#.....#..#....#...#........#.......
...#.#.#..#.#..#...#.#....#..#..###...#..#...##........#...#.###..#..#........#....###.##.#.....
.##......####..#.##..###.#....#..#.#.#...#...###......##.##....####.###...#.###...#..#.##...#...
..####..#.#..........#...#...#.#.....##...#....#.....####...#####.....#.#....##..####......#.#..
#.###.####..##.....#...##...#...#...#.#.....#....##..#....#......###.#...#..###..###....#.......
......#....#....#......####..#.#.#......#..#.........##.......#.....##...#.#......#....#.#......
...#....#.##.....##...#..#.....#.#..###.#.#..#.#........#.......#..#..#.#.###.....####.#........
..##.......##..###.#...#.##...#.##....#..####.##.##..#.##.#..##.##..#.#..#....#.#..#.#.....#...#
#.#......#.##......###.#..#.#...#..#.##..#.####.#..........#.#..##.....##....#.#..#.###..#.##.#.
.###..........#......#.#.#...#..###.##....#.#.##....###..#..#.#.#.#...#..###.#.#..#.....###.#.#.
#.#....#..#..........#..#..#....#.#..#.........#....###..#.#.....#...#....#...#.#..##.....#.....
.........##....#........#.....##..#.#..#.##.....#...#.......#......#.#..#...##.#..........#.###.
.#.#..#....#..#....###...#....####....#...#...#.#..##...##......#.##..#.#..#....#....##.........
#..#...###....#......##.....#####........#..##...##...#..#.#.#...###..#.......#....#....#..#..#.
##.......#.##.#....##......#.............##.............#..##..###.##.....#.###...#...#.#.....#.
..#..#..#....#.#..#.#.#..#.........#..#...#.###..#.###....###...#.#.#.#.....##.####.##..#.#..#..
.#..#...#..#..##........#.....#...........###...#........##......#.###..#....#...###.###..####..
......#.#...#...#..#...##...#.#..#......#...##..#............##....###.#...####.#...#...#.#...##
...#......#........#.#..#..##......#....#.#............#..#.#..##.##.#......#...#.#.....#.......
..#.#.......#.#.............#.#.##..#..#.#.......#.......#.#...#.#...#.......#...#..##...##.#.##
#...#.....##.#...##......#...#.#......#.####...##..#..#....##...##..#.........##.....#......##..
..#....#.........#..#.#.....#.....#..###.##..........##......####.#...#.....#..#.#.#.#..#.......
....#.....#.#.....##.#......#..#...........###.##.#..#......#...##.#.###....#.##....###...##..#.
............##.##..#.......#...........####..#.###..####.##.#..#...#.#...#...#.#.#....##.#.#....
..#....#..#..#....###.............#..#.#..........##.......#....#...#..##........##..#..#..#....
